NO ./path_to_the_north_texture
SO ./path_to_the_south_texture
EA ./path_to_the_east_texture



WE ./path_to_the_west_texture
F 220,100,55
C 225,30,77


111111111
100000001
100100001
101000001
1N0000001
111111111